,FullGeoName,Year,County,Activity,Reported human cases,Neuroinvasive disease cases,Identified by Blood Donor Screening,totals
0,"AL, Autauga",2023,1001,Human infections,1,1,0,2
1,"AL, Baldwin",2023,1003,Human infections and non-human activity,0,0,1,1
2,"AL, Calhoun",2023,1015,Human infections,2,2,0,4
3,"AL, Dale",2023,1045,Human infections,0,0,1,1
4,"AL, Etowah",2023,1055,Human infections,1,1,0,2
5,"AL, Houston",2023,1069,Human infections,1,1,0,2
6,"AL, Jefferson",2023,1073,Human infections,6,5,0,11
7,"AL, Madison",2023,1089,Human infections,1,0,0,1
8,"AL, Marshall",2023,1095,Non-human activity,0,0,0,0
9,"AL, Mobile",2023,1097,Human infections and non-human activity,4,3,1,8
10,"AL, Monroe",2023,1099,Non-human activity,0,0,0,0
11,"AL, Montgomery",2023,1101,Human infections,3,3,0,6
12,"AL, Morgan",2023,1103,Human infections,1,1,0,2
13,"AL, Shelby",2023,1117,Human infections,2,2,0,4
14,"AL, Talladega",2023,1121,Human infections,2,2,0,4
15,"AL, Tallapoosa",2023,1123,Human infections,1,1,0,2
16,"AL, Tuscaloosa",2023,1125,Human infections,1,1,0,2
17,"AZ, Apache",2023,4001,Human infections,1,1,0,2
18,"AZ, Gila",2023,4007,Non-human activity,0,0,0,0
19,"AZ, Graham",2023,4009,Human infections,1,0,0,1
20,"AZ, La Paz",2023,4012,Non-human activity,0,0,0,0
21,"AZ, Maricopa",2023,4013,Human infections and non-human activity,72,58,8,138
22,"AZ, Mohave",2023,4015,Human infections and non-human activity,1,1,0,2
23,"AZ, Navajo",2023,4017,Human infections,1,1,0,2
24,"AZ, Pima",2023,4019,Human infections,1,1,0,2
25,"AZ, Pinal",2023,4021,Non-human activity,0,0,0,0
26,"AZ, Yavapai",2023,4025,Human infections,2,1,0,3
27,"AZ, Yuma",2023,4027,Human infections and non-human activity,3,1,0,4
28,"AR, Dallas",2023,5039,Human infections,1,1,0,2
29,"AR, Drew",2023,5043,Human infections,1,1,0,2
30,"AR, Garland",2023,5051,Human infections,2,1,0,3
31,"AR, Greene",2023,5055,Human infections,1,1,0,2
32,"AR, Jefferson",2023,5069,Human infections,2,2,0,4
33,"AR, Monroe",2023,5095,Non-human activity,0,0,0,0
34,"AR, Pulaski",2023,5119,Human infections,3,1,0,4
35,"AR, Union",2023,5139,Human infections,1,0,0,1
36,"CA, Alameda",2023,6001,Human infections and non-human activity,1,1,1,3
37,"CA, Amador",2023,6005,Human infections,0,0,1,1
38,"CA, Butte",2023,6007,Human infections and non-human activity,15,8,1,24
39,"CA, Calaveras",2023,6009,Human infections and non-human activity,1,1,0,2
40,"CA, Colusa",2023,6011,Human infections and non-human activity,1,1,0,2
41,"CA, Contra Costa",2023,6013,Human infections and non-human activity,10,6,2,18
42,"CA, El Dorado",2023,6017,Human infections and non-human activity,3,3,0,6
43,"CA, Fresno",2023,6019,Human infections and non-human activity,23,16,2,41
44,"CA, Glenn",2023,6021,Human infections and non-human activity,4,3,0,7
45,"CA, Imperial",2023,6025,Human infections and non-human activity,1,0,0,1
46,"CA, Inyo",2023,6027,Non-human activity,0,0,0,0
47,"CA, Kern",2023,6029,Human infections and non-human activity,16,11,3,30
48,"CA, Kings",2023,6031,Human infections and non-human activity,8,4,3,15
49,"CA, Lake",2023,6033,Human infections and non-human activity,6,5,0,11
50,"CA, Los Angeles",2023,6037,Human infections and non-human activity,53,48,6,107
51,"CA, Madera",2023,6039,Human infections and non-human activity,8,7,0,15
52,"CA, Marin",2023,6041,Non-human activity,0,0,0,0
53,"CA, Merced",2023,6047,Human infections and non-human activity,8,5,1,14
54,"CA, Monterey",2023,6053,Human infections,2,2,0,4
55,"CA, Napa",2023,6055,Non-human activity,0,0,0,0
56,"CA, Nevada",2023,6057,Human infections and non-human activity,1,1,0,2
57,"CA, Orange",2023,6059,Human infections and non-human activity,5,5,1,11
58,"CA, Placer",2023,6061,Human infections and non-human activity,6,6,0,12
59,"CA, Riverside",2023,6065,Human infections and non-human activity,18,9,2,29
60,"CA, Sacramento",2023,6067,Human infections and non-human activity,50,43,7,100
61,"CA, San Benito",2023,6069,Non-human activity,0,0,0,0
62,"CA, San Bernardino",2023,6071,Human infections and non-human activity,28,25,2,55
63,"CA, San Diego",2023,6073,Non-human activity,0,0,0,0
64,"CA, San Joaquin",2023,6077,Human infections and non-human activity,15,13,2,30
65,"CA, San Luis Obispo",2023,6079,Human infections and non-human activity,2,2,0,4
66,"CA, San Mateo",2023,6081,Human infections and non-human activity,3,3,1,7
67,"CA, Santa Clara",2023,6085,Human infections and non-human activity,3,2,0,5
68,"CA, Shasta",2023,6089,Human infections and non-human activity,6,6,0,12
69,"CA, Siskiyou",2023,6093,Non-human activity,0,0,0,0
70,"CA, Solano",2023,6095,Human infections and non-human activity,5,3,1,9
71,"CA, Sonoma",2023,6097,Human infections and non-human activity,1,1,0,2
72,"CA, Stanislaus",2023,6099,Human infections and non-human activity,31,23,1,55
73,"CA, Sutter",2023,6101,Human infections and non-human activity,7,6,0,13
74,"CA, Tehama",2023,6103,Non-human activity,0,0,0,0
75,"CA, Tulare",2023,6107,Human infections and non-human activity,25,19,0,44
76,"CA, Ventura",2023,6111,Human infections and non-human activity,1,1,0,2
77,"CA, Yolo",2023,6113,Human infections and non-human activity,37,22,7,66
78,"CA, Yuba",2023,6115,Human infections and non-human activity,5,4,0,9
79,"CO, Adams",2023,8001,Human infections and non-human activity,45,23,3,71
80,"CO, Alamosa",2023,8003,Human infections and non-human activity,2,0,0,2
81,"CO, Arapahoe",2023,8005,Human infections and non-human activity,56,27,13,96
82,"CO, Archuleta",2023,8007,Human infections and non-human activity,2,1,0,3
83,"CO, Baca",2023,8009,Human infections,2,1,0,3
84,"CO, Bent",2023,8011,Human infections and non-human activity,0,0,1,1
85,"CO, Boulder",2023,8013,Human infections and non-human activity,29,14,3,46
86,"CO, Broomfield",2023,8014,Human infections,5,2,2,9
87,"CO, Chaffee",2023,8015,Human infections,10,2,0,12
88,"CO, Conejos",2023,8021,Non-human activity,0,0,0,0
89,"CO, Crowley",2023,8025,Human infections,1,1,0,2
90,"CO, Custer",2023,8027,Human infections and non-human activity,1,0,0,1
91,"CO, Delta",2023,8029,Human infections and non-human activity,7,0,0,7
92,"CO, Denver",2023,8031,Human infections and non-human activity,97,59,15,171
93,"CO, Douglas",2023,8035,Human infections and non-human activity,32,14,16,62
94,"CO, Elbert",2023,8039,Human infections and non-human activity,3,1,3,7
95,"CO, El Paso",2023,8041,Human infections and non-human activity,51,32,18,101
96,"CO, Fremont",2023,8043,Human infections and non-human activity,15,8,1,24
97,"CO, Garfield",2023,8045,Non-human activity,0,0,0,0
98,"CO, Grand",2023,8049,Human infections,1,1,0,2
99,"CO, Gunnison",2023,8051,Human infections,1,1,0,2
100,"CO, Huerfano",2023,8055,Human infections and non-human activity,1,0,1,2
101,"CO, Jefferson",2023,8059,Human infections and non-human activity,65,39,19,123
102,"CO, Kiowa",2023,8061,Human infections,1,1,0,2
103,"CO, Kit Carson",2023,8063,Human infections,3,1,0,4
104,"CO, La Plata",2023,8067,Human infections and non-human activity,11,7,3,21
105,"CO, Larimer",2023,8069,Human infections and non-human activity,52,18,8,78
106,"CO, Las Animas",2023,8071,Human infections and non-human activity,2,1,0,3
107,"CO, Lincoln",2023,8073,Human infections and non-human activity,2,1,0,3
108,"CO, Logan",2023,8075,Human infections,6,2,0,8
109,"CO, Mesa",2023,8077,Human infections,15,11,3,29
110,"CO, Moffat",2023,8081,Human infections,0,0,1,1
111,"CO, Montezuma",2023,8083,Human infections,5,2,0,7
112,"CO, Montrose",2023,8085,Human infections,2,0,1,3
113,"CO, Morgan",2023,8087,Human infections,11,7,1,19
114,"CO, Otero",2023,8089,Human infections,2,1,2,5
115,"CO, Phillips",2023,8095,Human infections,1,0,0,1
116,"CO, Prowers",2023,8099,Human infections,8,1,0,9
117,"CO, Pueblo",2023,8101,Human infections and non-human activity,25,12,3,40
118,"CO, Rio Grande",2023,8105,Non-human activity,0,0,0,0
119,"CO, Saguache",2023,8109,Human infections and non-human activity,1,0,0,1
120,"CO, Summit",2023,8117,Human infections,1,1,0,2
121,"CO, Teller",2023,8119,Human infections,4,3,0,7
122,"CO, Washington",2023,8121,Human infections,3,2,0,5
123,"CO, Weld",2023,8123,Human infections and non-human activity,53,19,5,77
124,"CO, Yuma",2023,8125,Non-human activity,0,0,0,0
125,"CT, Fairfield",2023,9001,Human infections and non-human activity,1,0,0,1
126,"CT, Hartford",2023,9003,Human infections and non-human activity,2,1,0,3
127,"CT, Middlesex",2023,9007,Non-human activity,0,0,0,0
128,"CT, New Haven",2023,9009,Human infections and non-human activity,1,0,0,1
129,"CT, New London",2023,9011,Non-human activity,0,0,0,0
130,"CT, Tolland",2023,9013,Non-human activity,0,0,0,0
131,"CT, Windham",2023,9015,Non-human activity,0,0,0,0
132,"DE, Kent",2023,10001,Non-human activity,0,0,0,0
133,"DE, New Castle",2023,10003,Human infections and non-human activity,4,4,2,10
134,"DE, Sussex",2023,10005,Non-human activity,0,0,0,0
135,"DC, Washington",2023,11001,Human infections and non-human activity,1,1,0,2
136,"FL, Alachua",2023,12001,Non-human activity,0,0,0,0
137,"FL, Bay",2023,12005,Human infections and non-human activity,0,0,1,1
138,"FL, Brevard",2023,12009,Human infections and non-human activity,1,1,0,2
139,"FL, Citrus",2023,12017,Non-human activity,0,0,0,0
140,"FL, Collier",2023,12021,Human infections,1,1,0,2
141,"FL, Duval",2023,12031,Human infections and non-human activity,1,1,0,2
142,"FL, Escambia",2023,12033,Human infections,6,4,2,12
143,"FL, Hernando",2023,12053,Non-human activity,0,0,0,0
144,"FL, Hillsborough",2023,12057,Human infections and non-human activity,0,0,1,1
145,"FL, Lee",2023,12071,Human infections and non-human activity,1,1,0,2
146,"FL, Leon",2023,12073,Non-human activity,0,0,0,0
147,"FL, Martin",2023,12085,Non-human activity,0,0,0,0
148,"FL, Nassau",2023,12089,Non-human activity,0,0,0,0
149,"FL, Okaloosa",2023,12091,Human infections,1,1,0,2
150,"FL, Orange",2023,12095,Non-human activity,0,0,0,0
151,"FL, Palm Beach",2023,12099,Non-human activity,0,0,0,0
152,"FL, Pinellas",2023,12103,Non-human activity,0,0,0,0
153,"FL, St Johns",2023,12109,Human infections and non-human activity,1,1,0,2
154,"FL, Santa Rosa",2023,12113,Non-human activity,0,0,0,0
155,"FL, Sarasota",2023,12115,Human infections and non-human activity,1,0,0,1
156,"FL, Seminole",2023,12117,Non-human activity,0,0,0,0
157,"FL, Volusia",2023,12127,Non-human activity,0,0,0,0
158,"FL, Wakulla",2023,12129,Human infections and non-human activity,1,1,0,2
159,"FL, Walton",2023,12131,Human infections and non-human activity,0,0,1,1
160,"GA, Brantley",2023,13025,Human infections,1,1,0,2
161,"GA, Chatham",2023,13051,Non-human activity,0,0,0,0
162,"GA, Cherokee",2023,13057,Human infections,1,0,2,3
163,"GA, Clayton",2023,13063,Human infections,1,1,0,2
164,"GA, Cobb",2023,13067,Human infections,2,2,1,5
165,"GA, Decatur",2023,13087,Human infections,1,1,0,2
166,"GA, De Kalb",2023,13089,Human infections and non-human activity,4,4,0,8
167,"GA, Fulton",2023,13121,Human infections and non-human activity,5,4,1,10
168,"GA, Gwinnett",2023,13135,Human infections,0,0,2,2
169,"GA, Lowndes",2023,13185,Non-human activity,0,0,0,0
170,"GA, Muscogee",2023,13215,Human infections,3,3,3,9
171,"GA, Richmond",2023,13245,Human infections,1,1,0,2
172,"GA, Troup",2023,13285,Human infections,0,0,1,1
173,"ID, Ada",2023,16001,Human infections and non-human activity,5,3,2,10
174,"ID, Bannock",2023,16005,Non-human activity,0,0,0,0
175,"ID, Bear Lake",2023,16007,Non-human activity,0,0,0,0
176,"ID, Bingham",2023,16011,Human infections and non-human activity,2,1,1,4
177,"ID, Bonneville",2023,16019,Non-human activity,0,0,0,0
178,"ID, Canyon",2023,16027,Human infections and non-human activity,7,7,0,14
179,"ID, Caribou",2023,16029,Non-human activity,0,0,0,0
180,"ID, Cassia",2023,16031,Human infections,1,0,0,1
181,"ID, Elmore",2023,16039,Non-human activity,0,0,0,0
182,"ID, Franklin",2023,16041,Non-human activity,0,0,0,0
183,"ID, Gem",2023,16045,Human infections and non-human activity,1,1,0,2
184,"ID, Gooding",2023,16047,Human infections,4,3,0,7
185,"ID, Kootenai",2023,16055,Human infections,1,1,0,2
186,"ID, Owyhee",2023,16073,Human infections and non-human activity,3,2,0,5
187,"ID, Payette",2023,16075,Human infections and non-human activity,1,1,0,2
188,"ID, Power",2023,16077,Non-human activity,0,0,0,0
189,"ID, Teton",2023,16081,Non-human activity,0,0,0,0
190,"ID, Twin Falls",2023,16083,Human infections and non-human activity,4,3,0,7
191,"ID, Valley",2023,16085,Human infections,1,0,0,1
192,"ID, Washington",2023,16087,Human infections,6,5,1,12
193,"IL, Adams",2023,17001,Human infections,1,1,0,2
194,"IL, Boone",2023,17007,Non-human activity,0,0,0,0
195,"IL, Bureau",2023,17011,Non-human activity,0,0,0,0
196,"IL, Carroll",2023,17015,Non-human activity,0,0,0,0
197,"IL, Champaign",2023,17019,Human infections and non-human activity,1,1,1,3
198,"IL, Christian",2023,17021,Non-human activity,0,0,0,0
199,"IL, Clay",2023,17025,Non-human activity,0,0,0,0
200,"IL, Clinton",2023,17027,Non-human activity,0,0,0,0
201,"IL, Coles",2023,17029,Human infections and non-human activity,2,2,0,4
202,"IL, Cook",2023,17031,Human infections and non-human activity,61,54,11,126
203,"IL, De Kalb",2023,17037,Human infections and non-human activity,0,0,1,1
204,"IL, Douglas",2023,17041,Non-human activity,0,0,0,0
205,"IL, Du Page",2023,17043,Human infections and non-human activity,15,14,7,36
206,"IL, Edgar",2023,17045,Human infections,1,1,0,2
207,"IL, Fayette",2023,17051,Non-human activity,0,0,0,0
208,"IL, Ford",2023,17053,Non-human activity,0,0,0,0
209,"IL, Gallatin",2023,17059,Non-human activity,0,0,0,0
210,"IL, Greene",2023,17061,Non-human activity,0,0,0,0
211,"IL, Grundy",2023,17063,Non-human activity,0,0,0,0
212,"IL, Hancock",2023,17067,Non-human activity,0,0,0,0
213,"IL, Henderson",2023,17071,Non-human activity,0,0,0,0
214,"IL, Henry",2023,17073,Human infections,0,0,1,1
215,"IL, Jackson",2023,17077,Non-human activity,0,0,0,0
216,"IL, Jefferson",2023,17081,Human infections,0,0,1,1
217,"IL, Jersey",2023,17083,Non-human activity,0,0,0,0
218,"IL, Kane",2023,17089,Human infections and non-human activity,7,7,6,20
219,"IL, Kankakee",2023,17091,Non-human activity,0,0,0,0
220,"IL, Kendall",2023,17093,Human infections and non-human activity,1,0,2,3
221,"IL, Knox",2023,17095,Non-human activity,0,0,0,0
222,"IL, Lake",2023,17097,Human infections and non-human activity,1,1,0,2
223,"IL, La Salle",2023,17099,Non-human activity,0,0,0,0
224,"IL, Lawrence",2023,17101,Non-human activity,0,0,0,0
225,"IL, Lee",2023,17103,Human infections and non-human activity,1,1,0,2
226,"IL, Livingston",2023,17105,Non-human activity,0,0,0,0
227,"IL, Logan",2023,17107,Non-human activity,0,0,0,0
228,"IL, Mcdonough",2023,17109,Non-human activity,0,0,0,0
229,"IL, Mchenry",2023,17111,Human infections and non-human activity,1,1,0,2
230,"IL, Mclean",2023,17113,Non-human activity,0,0,0,0
231,"IL, Macon",2023,17115,Human infections and non-human activity,2,2,0,4
232,"IL, Macoupin",2023,17117,Non-human activity,0,0,0,0
233,"IL, Madison",2023,17119,Human infections and non-human activity,2,1,1,4
234,"IL, Marion",2023,17121,Human infections,1,1,0,2
235,"IL, Marshall",2023,17123,Human infections and non-human activity,1,1,0,2
236,"IL, Mason",2023,17125,Non-human activity,0,0,0,0
237,"IL, Massac",2023,17127,Non-human activity,0,0,0,0
238,"IL, Menard",2023,17129,Non-human activity,0,0,0,0
239,"IL, Mercer",2023,17131,Non-human activity,0,0,0,0
240,"IL, Monroe",2023,17133,Non-human activity,0,0,0,0
241,"IL, Montgomery",2023,17135,Non-human activity,0,0,0,0
242,"IL, Morgan",2023,17137,Non-human activity,0,0,0,0
243,"IL, Moultrie",2023,17139,Human infections and non-human activity,0,0,1,1
244,"IL, Ogle",2023,17141,Human infections and non-human activity,1,1,0,2
245,"IL, Peoria",2023,17143,Human infections and non-human activity,3,3,0,6
246,"IL, Piatt",2023,17147,Non-human activity,0,0,0,0
247,"IL, Putnam",2023,17155,Non-human activity,0,0,0,0
248,"IL, Rock Island",2023,17161,Human infections and non-human activity,1,1,1,3
249,"IL, St Clair",2023,17163,Human infections and non-human activity,3,3,2,8
250,"IL, Saline",2023,17165,Non-human activity,0,0,0,0
251,"IL, Sangamon",2023,17167,Human infections and non-human activity,1,1,0,2
252,"IL, Stephenson",2023,17177,Human infections and non-human activity,1,1,0,2
253,"IL, Tazewell",2023,17179,Human infections and non-human activity,0,0,1,1
254,"IL, Vermilion",2023,17183,Non-human activity,0,0,0,0
255,"IL, Warren",2023,17187,Non-human activity,0,0,0,0
256,"IL, Washington",2023,17189,Non-human activity,0,0,0,0
257,"IL, Whiteside",2023,17195,Non-human activity,0,0,0,0
258,"IL, Will",2023,17197,Human infections and non-human activity,4,3,4,11
259,"IL, Williamson",2023,17199,Non-human activity,0,0,0,0
260,"IL, Winnebago",2023,17201,Human infections and non-human activity,2,1,1,4
261,"IL, Woodford",2023,17203,Human infections,2,0,0,2
262,"IN, Adams",2023,18001,Non-human activity,0,0,0,0
263,"IN, Allen",2023,18003,Non-human activity,0,0,0,0
264,"IN, Bartholomew",2023,18005,Non-human activity,0,0,0,0
265,"IN, Benton",2023,18007,Non-human activity,0,0,0,0
266,"IN, Blackford",2023,18009,Non-human activity,0,0,0,0
267,"IN, Boone",2023,18011,Non-human activity,0,0,0,0
268,"IN, Brown",2023,18013,Non-human activity,0,0,0,0
269,"IN, Carroll",2023,18015,Non-human activity,0,0,0,0
270,"IN, Cass",2023,18017,Non-human activity,0,0,0,0
271,"IN, Clark",2023,18019,Non-human activity,0,0,0,0
272,"IN, Clay",2023,18021,Non-human activity,0,0,0,0
273,"IN, Clinton",2023,18023,Non-human activity,0,0,0,0
274,"IN, Crawford",2023,18025,Non-human activity,0,0,0,0
275,"IN, Daviess",2023,18027,Non-human activity,0,0,0,0
276,"IN, Dearborn",2023,18029,Non-human activity,0,0,0,0
277,"IN, Decatur",2023,18031,Non-human activity,0,0,0,0
278,"IN, De Kalb",2023,18033,Non-human activity,0,0,0,0
279,"IN, Delaware",2023,18035,Non-human activity,0,0,0,0
280,"IN, Dubois",2023,18037,Non-human activity,0,0,0,0
281,"IN, Elkhart",2023,18039,Human infections and non-human activity,1,1,0,2
282,"IN, Fayette",2023,18041,Non-human activity,0,0,0,0
283,"IN, Floyd",2023,18043,Human infections and non-human activity,1,0,1,2
284,"IN, Fountain",2023,18045,Non-human activity,0,0,0,0
285,"IN, Franklin",2023,18047,Non-human activity,0,0,0,0
286,"IN, Fulton",2023,18049,Non-human activity,0,0,0,0
287,"IN, Gibson",2023,18051,Non-human activity,0,0,0,0
288,"IN, Grant",2023,18053,Non-human activity,0,0,0,0
289,"IN, Greene",2023,18055,Non-human activity,0,0,0,0
290,"IN, Hamilton",2023,18057,Non-human activity,0,0,0,0
291,"IN, Hancock",2023,18059,Non-human activity,0,0,0,0
292,"IN, Harrison",2023,18061,Non-human activity,0,0,0,0
293,"IN, Hendricks",2023,18063,Non-human activity,0,0,0,0
294,"IN, Henry",2023,18065,Non-human activity,0,0,0,0
295,"IN, Howard",2023,18067,Non-human activity,0,0,0,0
296,"IN, Huntington",2023,18069,Non-human activity,0,0,0,0
297,"IN, Jackson",2023,18071,Non-human activity,0,0,0,0
298,"IN, Jasper",2023,18073,Non-human activity,0,0,0,0
299,"IN, Jay",2023,18075,Non-human activity,0,0,0,0
300,"IN, Jefferson",2023,18077,Non-human activity,0,0,0,0
301,"IN, Jennings",2023,18079,Non-human activity,0,0,0,0
302,"IN, Johnson",2023,18081,Human infections and non-human activity,1,1,0,2
303,"IN, Knox",2023,18083,Non-human activity,0,0,0,0
304,"IN, Kosciusko",2023,18085,Non-human activity,0,0,0,0
305,"IN, La Grange",2023,18087,Non-human activity,0,0,0,0
306,"IN, Lake",2023,18089,Non-human activity,0,0,0,0
307,"IN, La Porte",2023,18091,Human infections and non-human activity,1,1,0,2
308,"IN, Lawrence",2023,18093,Non-human activity,0,0,0,0
309,"IN, Madison",2023,18095,Non-human activity,0,0,0,0
310,"IN, Marion",2023,18097,Human infections and non-human activity,1,0,1,2
311,"IN, Marshall",2023,18099,Non-human activity,0,0,0,0
312,"IN, Martin",2023,18101,Non-human activity,0,0,0,0
313,"IN, Miami",2023,18103,Non-human activity,0,0,0,0
314,"IN, Monroe",2023,18105,Human infections and non-human activity,1,1,0,2
315,"IN, Montgomery",2023,18107,Non-human activity,0,0,0,0
316,"IN, Morgan",2023,18109,Human infections and non-human activity,1,1,0,2
317,"IN, Newton",2023,18111,Non-human activity,0,0,0,0
318,"IN, Noble",2023,18113,Non-human activity,0,0,0,0
319,"IN, Ohio",2023,18115,Non-human activity,0,0,0,0
320,"IN, Orange",2023,18117,Non-human activity,0,0,0,0
321,"IN, Owen",2023,18119,Non-human activity,0,0,0,0
322,"IN, Parke",2023,18121,Non-human activity,0,0,0,0
323,"IN, Perry",2023,18123,Human infections and non-human activity,1,1,0,2
324,"IN, Pike",2023,18125,Non-human activity,0,0,0,0
325,"IN, Porter",2023,18127,Human infections and non-human activity,3,1,0,4
326,"IN, Posey",2023,18129,Non-human activity,0,0,0,0
327,"IN, Pulaski",2023,18131,Non-human activity,0,0,0,0
328,"IN, Putnam",2023,18133,Non-human activity,0,0,0,0
329,"IN, Randolph",2023,18135,Human infections and non-human activity,1,1,0,2
330,"IN, Ripley",2023,18137,Non-human activity,0,0,0,0
331,"IN, Rush",2023,18139,Non-human activity,0,0,0,0
332,"IN, St Joseph",2023,18141,Non-human activity,0,0,0,0
333,"IN, Scott",2023,18143,Non-human activity,0,0,0,0
334,"IN, Shelby",2023,18145,Non-human activity,0,0,0,0
335,"IN, Spencer",2023,18147,Non-human activity,0,0,0,0
336,"IN, Starke",2023,18149,Non-human activity,0,0,0,0
337,"IN, Steuben",2023,18151,Non-human activity,0,0,0,0
338,"IN, Sullivan",2023,18153,Human infections and non-human activity,0,0,1,1
339,"IN, Switzerland",2023,18155,Non-human activity,0,0,0,0
340,"IN, Tippecanoe",2023,18157,Human infections and non-human activity,1,1,0,2
341,"IN, Tipton",2023,18159,Non-human activity,0,0,0,0
342,"IN, Union",2023,18161,Non-human activity,0,0,0,0
343,"IN, Vanderburgh",2023,18163,Human infections and non-human activity,0,0,1,1
344,"IN, Vermillion",2023,18165,Non-human activity,0,0,0,0
345,"IN, Vigo",2023,18167,Non-human activity,0,0,0,0
346,"IN, Wabash",2023,18169,Non-human activity,0,0,0,0
347,"IN, Warren",2023,18171,Non-human activity,0,0,0,0
348,"IN, Warrick",2023,18173,Non-human activity,0,0,0,0
349,"IN, Washington",2023,18175,Non-human activity,0,0,0,0
350,"IN, Wayne",2023,18177,Non-human activity,0,0,0,0
351,"IN, Wells",2023,18179,Non-human activity,0,0,0,0
352,"IN, White",2023,18181,Non-human activity,0,0,0,0
353,"IN, Whitley",2023,18183,Non-human activity,0,0,0,0
354,"IA, Adams",2023,19003,Human infections,1,1,0,2
355,"IA, Appanoose",2023,19007,Non-human activity,0,0,0,0
356,"IA, Black Hawk",2023,19013,Non-human activity,0,0,0,0
357,"IA, Clay",2023,19041,Human infections,0,0,1,1
358,"IA, Clinton",2023,19045,Human infections,1,1,0,2
359,"IA, Dubuque",2023,19061,Human infections,1,0,0,1
360,"IA, Johnson",2023,19103,Non-human activity,0,0,0,0
361,"IA, Lee",2023,19111,Human infections,1,1,0,2
362,"IA, Linn",2023,19113,Human infections,1,0,0,1
363,"IA, Lyon",2023,19119,Human infections,1,1,0,2
364,"IA, O Brien",2023,19141,Human infections and non-human activity,0,0,1,1
365,"IA, Page",2023,19145,Human infections,1,1,0,2
366,"IA, Plymouth",2023,19149,Human infections,3,3,1,7
367,"IA, Pocahontas",2023,19151,Human infections,1,1,0,2
368,"IA, Polk",2023,19153,Human infections and non-human activity,1,1,1,3
369,"IA, Sioux",2023,19167,Human infections,2,1,0,3
370,"IA, Story",2023,19169,Non-human activity,0,0,0,0
371,"IA, Warren",2023,19181,Human infections,1,1,0,2
372,"IA, Wayne",2023,19185,Human infections,1,0,1,2
373,"IA, Woodbury",2023,19193,Human infections and non-human activity,1,0,0,1
374,"KS, Barber",2023,20007,Human infections and non-human activity,1,0,0,1
375,"KS, Barton",2023,20009,Human infections,2,2,0,4
376,"KS, Butler",2023,20015,Human infections and non-human activity,1,1,0,2
377,"KS, Cheyenne",2023,20023,Human infections,2,2,0,4
378,"KS, Clark",2023,20025,Non-human activity,0,0,0,0
379,"KS, Coffey",2023,20031,Non-human activity,0,0,0,0
380,"KS, Cowley",2023,20035,Human infections,1,0,0,1
381,"KS, Decatur",2023,20039,Human infections,1,1,0,2
382,"KS, Dickinson",2023,20041,Human infections,1,1,0,2
383,"KS, Douglas",2023,20045,Human infections and non-human activity,1,1,0,2
384,"KS, Finney",2023,20055,Human infections,2,0,3,5
385,"KS, Ford",2023,20057,Human infections,1,0,0,1
386,"KS, Grant",2023,20067,Human infections,4,2,0,6
387,"KS, Gray",2023,20069,Human infections,4,4,2,10
388,"KS, Greenwood",2023,20073,Non-human activity,0,0,0,0
389,"KS, Hamilton",2023,20075,Human infections,1,1,0,2
390,"KS, Harvey",2023,20079,Human infections,0,0,3,3
391,"KS, Haskell",2023,20081,Human infections,0,0,1,1
392,"KS, Johnson",2023,20091,Human infections and non-human activity,5,5,6,16
393,"KS, Kingman",2023,20095,Human infections,1,1,0,2
394,"KS, Lane",2023,20101,Human infections,1,1,0,2
395,"KS, Logan",2023,20109,Human infections,1,0,0,1
396,"KS, Lyon",2023,20111,Non-human activity,0,0,0,0
397,"KS, Mcpherson",2023,20113,Human infections,0,0,1,1
398,"KS, Marshall",2023,20117,Human infections,1,1,0,2
399,"KS, Meade",2023,20119,Human infections,3,0,1,4
400,"KS, Miami",2023,20121,Human infections and non-human activity,1,1,0,2
401,"KS, Morris",2023,20127,Non-human activity,0,0,0,0
402,"KS, Morton",2023,20129,Human infections,1,1,0,2
403,"KS, Ness",2023,20135,Human infections,2,1,0,3
404,"KS, Norton",2023,20137,Human infections,1,0,0,1
405,"KS, Pratt",2023,20151,Non-human activity,0,0,0,0
406,"KS, Reno",2023,20155,Human infections,3,3,1,7
407,"KS, Rush",2023,20165,Human infections,0,0,1,1
408,"KS, Saline",2023,20169,Human infections,2,1,0,3
409,"KS, Scott",2023,20171,Human infections,2,1,0,3
410,"KS, Sedgwick",2023,20173,Human infections,6,5,8,19
411,"KS, Shawnee",2023,20177,Human infections and non-human activity,3,3,0,6
412,"KS, Sherman",2023,20181,Human infections,2,1,0,3
413,"KS, Smith",2023,20183,Human infections,0,0,1,1
414,"KS, Stafford",2023,20185,Human infections,0,0,1,1
415,"KS, Stanton",2023,20187,Human infections,1,0,1,2
416,"KS, Stevens",2023,20189,Human infections,3,3,0,6
417,"KS, Trego",2023,20195,Human infections,1,0,0,1
418,"KS, Wallace",2023,20199,Human infections,2,2,0,4
419,"KS, Wichita",2023,20203,Human infections,0,0,1,1
420,"KS, Woodson",2023,20207,Human infections,1,0,0,1
421,"KS, Wyandotte",2023,20209,Human infections,1,1,0,2
422,"KY, Calloway",2023,21035,Non-human activity,0,0,0,0
423,"KY, Christian",2023,21047,Non-human activity,0,0,0,0
424,"KY, Clark",2023,21049,Human infections,2,2,0,4
425,"KY, Daviess",2023,21059,Human infections,2,2,0,4
426,"KY, Graves",2023,21083,Non-human activity,0,0,0,0
427,"KY, Jefferson",2023,21111,Human infections,7,6,0,13
428,"KY, Madison",2023,21151,Non-human activity,0,0,0,0
429,"KY, Marshall",2023,21157,Non-human activity,0,0,0,0
430,"KY, Mason",2023,21161,Non-human activity,0,0,0,0
431,"KY, Simpson",2023,21213,Non-human activity,0,0,0,0
432,"KY, Todd",2023,21219,Non-human activity,0,0,0,0
433,"KY, Union",2023,21225,Non-human activity,0,0,0,0
434,"KY, Warren",2023,21227,Human infections and non-human activity,2,0,0,2
435,"KY, Woodford",2023,21239,Non-human activity,0,0,0,0
436,"LA, Allen Parish",2023,22003,Non-human activity,0,0,0,0
437,"LA, Ascension Parish",2023,22005,Human infections and non-human activity,5,5,0,10
438,"LA, Bienville Parish",2023,22013,Human infections,1,1,0,2
439,"LA, Bossier Parish",2023,22015,Human infections and non-human activity,1,1,0,2
440,"LA, Caddo Parish",2023,22017,Human infections and non-human activity,1,1,0,2
441,"LA, Calcasieu Parish",2023,22019,Human infections and non-human activity,3,2,0,5
442,"LA, Cameron Parish",2023,22023,Non-human activity,0,0,0,0
443,"LA, East Baton Rouge Parish",2023,22033,Human infections and non-human activity,5,5,1,11
444,"LA, Iberia Parish",2023,22045,Human infections and non-human activity,3,1,2,6
445,"LA, Jefferson Parish",2023,22051,Human infections and non-human activity,1,1,0,2
446,"LA, Jefferson Davis Parish",2023,22053,Non-human activity,0,0,0,0
447,"LA, Lafayette Parish",2023,22055,Human infections and non-human activity,7,6,2,15
448,"LA, Lafourche Parish",2023,22057,Human infections and non-human activity,1,1,2,4
449,"LA, Lincoln Parish",2023,22061,Non-human activity,0,0,0,0
450,"LA, Livingston Parish",2023,22063,Human infections,3,3,0,6
451,"LA, Orleans Parish",2023,22071,Non-human activity,0,0,0,0
452,"LA, Ouachita Parish",2023,22073,Human infections and non-human activity,1,1,3,5
453,"LA, Plaquemines Parish",2023,22075,Non-human activity,0,0,0,0
454,"LA, Pointe Coupee Parish",2023,22077,Human infections and non-human activity,1,1,0,2
455,"LA, Rapides Parish",2023,22079,Human infections,2,2,0,4
456,"LA, Richland Parish",2023,22083,Human infections,1,1,0,2
457,"LA, St Bernard Parish",2023,22087,Non-human activity,0,0,0,0
458,"LA, St Charles Parish",2023,22089,Non-human activity,0,0,0,0
459,"LA, St John The Baptist Parish",2023,22095,Human infections and non-human activity,1,1,0,2
460,"LA, St Martin Parish",2023,22099,Human infections and non-human activity,1,1,1,3
461,"LA, St Mary Parish",2023,22101,Non-human activity,0,0,0,0
462,"LA, St Tammany Parish",2023,22103,Human infections and non-human activity,3,2,0,5
463,"LA, Tangipahoa Parish",2023,22105,Human infections and non-human activity,0,0,1,1
464,"LA, Terrebonne Parish",2023,22109,Human infections and non-human activity,2,1,0,3
465,"LA, Washington Parish",2023,22117,Human infections,2,2,0,4
466,"LA, Webster Parish",2023,22119,Human infections,3,3,0,6
467,"LA, West Baton Rouge Parish",2023,22121,Human infections and non-human activity,2,1,0,3
468,"LA, West Carroll Parish",2023,22123,Human infections,1,1,1,3
469,"ME, Oxford",2023,23017,Non-human activity,0,0,0,0
470,"ME, Penobscot",2023,23019,Non-human activity,0,0,0,0
471,"ME, York",2023,23031,Non-human activity,0,0,0,0
472,"MA, Barnstable",2023,25001,Non-human activity,0,0,0,0
473,"MA, Berkshire",2023,25003,Non-human activity,0,0,0,0
474,"MA, Bristol",2023,25005,Non-human activity,0,0,0,0
475,"MA, Essex",2023,25009,Non-human activity,0,0,0,0
476,"MA, Franklin",2023,25011,Non-human activity,0,0,0,0
477,"MA, Hampden",2023,25013,Human infections and non-human activity,2,2,0,4
478,"MA, Hampshire",2023,25015,Non-human activity,0,0,0,0
479,"MA, Middlesex",2023,25017,Human infections and non-human activity,2,2,0,4
480,"MA, Norfolk",2023,25021,Human infections and non-human activity,1,0,1,2
481,"MA, Plymouth",2023,25023,Non-human activity,0,0,0,0
482,"MA, Suffolk",2023,25025,Non-human activity,0,0,0,0
483,"MA, Worcester",2023,25027,Human infections and non-human activity,1,1,0,2
484,"MI, Bay",2023,26017,Human infections and non-human activity,1,0,1,2
485,"MI, Berrien",2023,26021,Human infections and non-human activity,1,1,0,2
486,"MI, Calhoun",2023,26025,Non-human activity,0,0,0,0
487,"MI, Cass",2023,26027,Non-human activity,0,0,0,0
488,"MI, Chippewa",2023,26033,Non-human activity,0,0,0,0
489,"MI, Clare",2023,26035,Non-human activity,0,0,0,0
490,"MI, Clinton",2023,26037,Human infections,1,1,0,2
491,"MI, Genesee",2023,26049,Non-human activity,0,0,0,0
492,"MI, Gladwin",2023,26051,Non-human activity,0,0,0,0
493,"MI, Grand Traverse",2023,26055,Non-human activity,0,0,0,0
494,"MI, Gratiot",2023,26057,Non-human activity,0,0,0,0
495,"MI, Ingham",2023,26065,Human infections,1,1,0,2
496,"MI, Iosco",2023,26069,Non-human activity,0,0,0,0
497,"MI, Isabella",2023,26073,Human infections and non-human activity,1,0,1,2
498,"MI, Kalamazoo",2023,26077,Non-human activity,0,0,0,0
499,"MI, Kent",2023,26081,Human infections and non-human activity,2,2,0,4
500,"MI, Leelanau",2023,26089,Human infections,1,1,0,2
501,"MI, Lenawee",2023,26091,Human infections,1,1,0,2
502,"MI, Livingston",2023,26093,Non-human activity,0,0,0,0
503,"MI, Macomb",2023,26099,Human infections,1,1,0,2
504,"MI, Marquette",2023,26103,Non-human activity,0,0,0,0
505,"MI, Midland",2023,26111,Non-human activity,0,0,0,0
506,"MI, Oakland",2023,26125,Human infections and non-human activity,1,1,0,2
507,"MI, Ontonagon",2023,26131,Human infections and non-human activity,1,1,0,2
508,"MI, Otsego",2023,26137,Non-human activity,0,0,0,0
509,"MI, Ottawa",2023,26139,Human infections,2,2,0,4
510,"MI, Presque Isle",2023,26141,Non-human activity,0,0,0,0
511,"MI, Saginaw",2023,26145,Non-human activity,0,0,0,0
512,"MI, St Clair",2023,26147,Human infections,2,2,0,4
513,"MI, Sanilac",2023,26151,Human infections,1,1,0,2
514,"MI, Shiawassee",2023,26155,Human infections,1,1,0,2
515,"MI, Tuscola",2023,26157,Human infections and non-human activity,1,1,0,2
516,"MI, Washtenaw",2023,26161,Non-human activity,0,0,0,0
517,"MI, Wayne",2023,26163,Human infections and non-human activity,5,5,0,10
518,"MI, Wexford",2023,26165,Non-human activity,0,0,0,0
519,"MN, Anoka",2023,27003,Human infections and non-human activity,4,4,1,9
520,"MN, Big Stone",2023,27011,Human infections,1,1,1,3
521,"MN, Blue Earth",2023,27013,Human infections,1,1,1,3
522,"MN, Brown",2023,27015,Human infections,0,0,1,1
523,"MN, Carver",2023,27019,Non-human activity,0,0,0,0
524,"MN, Chippewa",2023,27023,Human infections,2,2,0,4
525,"MN, Clay",2023,27027,Human infections,1,1,1,3
526,"MN, Dakota",2023,27037,Human infections and non-human activity,3,2,3,8
527,"MN, Dodge",2023,27039,Human infections,0,0,1,1
528,"MN, Douglas",2023,27041,Human infections,1,0,1,2
529,"MN, Fillmore",2023,27045,Human infections,1,1,0,2
530,"MN, Grant",2023,27051,Human infections,1,0,0,1
531,"MN, Hennepin",2023,27053,Human infections and non-human activity,12,9,9,30
532,"MN, Houston",2023,27055,Human infections,1,1,0,2
533,"MN, Itasca",2023,27061,Human infections,3,2,1,6
534,"MN, Kandiyohi",2023,27067,Human infections and non-human activity,1,1,0,2
535,"MN, Kittson",2023,27069,Human infections,0,0,1,1
536,"MN, Lac Qui Parle",2023,27073,Human infections,1,1,0,2
537,"MN, Le Sueur",2023,27079,Human infections and non-human activity,1,1,0,2
538,"MN, Lyon",2023,27083,Human infections,4,1,2,7
539,"MN, Mcleod",2023,27085,Human infections,0,0,1,1
540,"MN, Martin",2023,27091,Human infections,2,0,1,3
541,"MN, Meeker",2023,27093,Human infections,1,1,0,2
542,"MN, Murray",2023,27101,Human infections and non-human activity,1,0,1,2
543,"MN, Nicollet",2023,27103,Human infections,1,0,4,5
544,"MN, Olmsted",2023,27109,Human infections,1,0,2,3
545,"MN, Otter Tail",2023,27111,Human infections,1,1,0,2
546,"MN, Pipestone",2023,27117,Human infections,0,0,2,2
547,"MN, Polk",2023,27119,Human infections,3,2,0,5
548,"MN, Ramsey",2023,27123,Human infections and non-human activity,1,1,6,8
549,"MN, Redwood",2023,27127,Human infections,1,1,0,2
550,"MN, Renville",2023,27129,Human infections,0,0,1,1
551,"MN, Rice",2023,27131,Human infections,1,1,1,3
552,"MN, Rock",2023,27133,Human infections,1,1,0,2
553,"MN, Scott",2023,27139,Human infections and non-human activity,3,2,1,6
554,"MN, Sherburne",2023,27141,Human infections,1,1,0,2
555,"MN, Sibley",2023,27143,Human infections and non-human activity,1,1,0,2
556,"MN, Stearns",2023,27145,Human infections,1,0,1,2
557,"MN, Steele",2023,27147,Human infections,1,1,1,3
558,"MN, Stevens",2023,27149,Human infections,1,0,0,1
559,"MN, Traverse",2023,27155,Human infections,1,1,0,2
560,"MN, Wabasha",2023,27157,Human infections,0,0,1,1
561,"MN, Waseca",2023,27161,Non-human activity,0,0,0,0
562,"MN, Washington",2023,27163,Human infections and non-human activity,1,1,1,3
563,"MN, Wilkin",2023,27167,Human infections,0,0,1,1
564,"MN, Winona",2023,27169,Non-human activity,0,0,0,0
565,"MN, Yellow Medicine",2023,27173,Human infections,1,1,0,2
566,"MS, Bolivar",2023,28011,Human infections,1,1,0,2
567,"MS, Calhoun",2023,28013,Human infections,1,1,0,2
568,"MS, Clarke",2023,28023,Human infections,2,1,0,3
569,"MS, De Soto",2023,28033,Human infections,0,0,2,2
570,"MS, Forrest",2023,28035,Human infections,2,2,0,4
571,"MS, Grenada",2023,28043,Human infections,1,1,0,2
572,"MS, Harrison",2023,28047,Non-human activity,0,0,0,0
573,"MS, Hinds",2023,28049,Human infections and non-human activity,6,3,1,10
574,"MS, Humphreys",2023,28053,Human infections,1,1,0,2
575,"MS, Jackson",2023,28059,Human infections and non-human activity,2,2,0,4
576,"MS, Lamar",2023,28073,Human infections,1,1,0,2
577,"MS, Leflore",2023,28083,Human infections,1,1,0,2
578,"MS, Lincoln",2023,28085,Human infections,2,1,1,4
579,"MS, Madison",2023,28089,Human infections and non-human activity,4,3,0,7
580,"MS, Monroe",2023,28095,Non-human activity,0,0,0,0
581,"MS, Panola",2023,28107,Human infections,3,3,0,6
582,"MS, Pike",2023,28113,Human infections,1,1,0,2
583,"MS, Pontotoc",2023,28115,Human infections,1,0,0,1
584,"MS, Prentiss",2023,28117,Human infections,2,2,0,4
585,"MS, Rankin",2023,28121,Human infections and non-human activity,4,2,0,6
586,"MS, Sunflower",2023,28133,Human infections and non-human activity,2,1,0,3
587,"MS, Tallahatchie",2023,28135,Human infections,0,0,1,1
588,"MS, Washington",2023,28151,Non-human activity,0,0,0,0
589,"MO, Adair",2023,29001,Non-human activity,0,0,0,0
590,"MO, Buchanan",2023,29021,Human infections,1,1,1,3
591,"MO, Butler",2023,29023,Human infections,1,1,0,2
592,"MO, Carter",2023,29035,Human infections,1,1,0,2
593,"MO, Christian",2023,29043,Human infections,0,0,1,1
594,"MO, Dallas",2023,29059,Human infections,1,1,0,2
595,"MO, Greene",2023,29077,Human infections,3,3,1,7
596,"MO, Jackson",2023,29095,Human infections,3,2,0,5
597,"MO, Jefferson",2023,29099,Non-human activity,0,0,0,0
598,"MO, Laclede",2023,29105,Human infections,2,2,0,4
599,"MO, Lawrence",2023,29109,Human infections,0,0,1,1
600,"MO, Marion",2023,29127,Human infections,1,1,0,2
601,"MO, Platte",2023,29165,Human infections,1,1,0,2
602,"MO, Pulaski",2023,29169,Human infections,1,1,0,2
603,"MO, St Charles",2023,29183,Human infections and non-human activity,3,2,1,6
604,"MO, St Louis",2023,29189,Human infections and non-human activity,9,9,5,23
605,"MO, Saline",2023,29195,Human infections,1,1,0,2
606,"MO, Shannon",2023,29203,Human infections,1,1,0,2
607,"MO, Texas",2023,29215,Human infections,1,1,0,2
608,"MO, Webster",2023,29225,Human infections,1,1,1,3
609,"MO, St Louis City",2023,29510,Human infections,4,4,0,8
610,"MT, Beaverhead",2023,30001,Non-human activity,0,0,0,0
611,"MT, Big Horn",2023,30003,Human infections,2,1,1,4
612,"MT, Blaine",2023,30005,Human infections and non-human activity,1,1,0,2
613,"MT, Broadwater",2023,30007,Non-human activity,0,0,0,0
614,"MT, Carbon",2023,30009,Human infections and non-human activity,1,1,0,2
615,"MT, Carter",2023,30011,Non-human activity,0,0,0,0
616,"MT, Cascade",2023,30013,Non-human activity,0,0,0,0
617,"MT, Custer",2023,30017,Human infections and non-human activity,1,0,0,1
618,"MT, Dawson",2023,30021,Human infections,3,2,0,5
619,"MT, Fergus",2023,30027,Non-human activity,0,0,0,0
620,"MT, Flathead",2023,30029,Human infections,1,0,1,2
621,"MT, Gallatin",2023,30031,Non-human activity,0,0,0,0
622,"MT, Glacier",2023,30035,Non-human activity,0,0,0,0
623,"MT, Hill",2023,30041,Non-human activity,0,0,0,0
624,"MT, Lake",2023,30047,Non-human activity,0,0,0,0
625,"MT, Lewis And Clark",2023,30049,Human infections and non-human activity,1,0,1,2
626,"MT, Mccone",2023,30055,Human infections,1,0,1,2
627,"MT, Park",2023,30067,Human infections and non-human activity,1,1,0,2
628,"MT, Phillips",2023,30071,Human infections and non-human activity,3,1,0,4
629,"MT, Powder River",2023,30075,Non-human activity,0,0,0,0
630,"MT, Prairie",2023,30079,Human infections,1,1,0,2
631,"MT, Richland",2023,30083,Human infections,7,3,1,11
632,"MT, Rosebud",2023,30087,Human infections and non-human activity,1,1,0,2
633,"MT, Sheridan",2023,30091,Human infections,1,1,1,3
634,"MT, Teton",2023,30099,Non-human activity,0,0,0,0
635,"MT, Toole",2023,30101,Non-human activity,0,0,0,0
636,"MT, Treasure",2023,30103,Non-human activity,0,0,0,0
637,"MT, Valley",2023,30105,Human infections and non-human activity,6,4,0,10
638,"MT, Yellowstone",2023,30111,Human infections and non-human activity,11,6,3,20
639,"NE, Adams",2023,31001,Human infections and non-human activity,3,3,0,6
640,"NE, Boone",2023,31011,Human infections,0,0,1,1
641,"NE, Box Butte",2023,31013,Human infections and non-human activity,4,3,0,7
642,"NE, Buffalo",2023,31019,Human infections,3,3,0,6
643,"NE, Cass",2023,31025,Human infections,1,0,0,1
644,"NE, Chase",2023,31029,Human infections,3,2,0,5
645,"NE, Cheyenne",2023,31033,Human infections,7,3,1,11
646,"NE, Clay",2023,31035,Human infections,0,0,1,1
647,"NE, Cuming",2023,31039,Human infections and non-human activity,2,2,0,4
648,"NE, Custer",2023,31041,Human infections,3,0,1,4
649,"NE, Dawes",2023,31045,Human infections,2,2,0,4
650,"NE, Dawson",2023,31047,Human infections and non-human activity,2,1,2,5
651,"NE, Deuel",2023,31049,Human infections,1,0,1,2
652,"NE, Dodge",2023,31053,Human infections and non-human activity,6,4,1,11
653,"NE, Douglas",2023,31055,Human infections and non-human activity,11,8,2,21
654,"NE, Dundy",2023,31057,Human infections,1,1,0,2
655,"NE, Fillmore",2023,31059,Human infections,1,1,1,3
656,"NE, Frontier",2023,31063,Non-human activity,0,0,0,0
657,"NE, Furnas",2023,31065,Human infections,1,1,0,2
658,"NE, Garden",2023,31069,Human infections,2,2,0,4
659,"NE, Garfield",2023,31071,Non-human activity,0,0,0,0
660,"NE, Hall",2023,31079,Human infections and non-human activity,2,1,3,6
661,"NE, Hamilton",2023,31081,Human infections,1,1,0,2
662,"NE, Harlan",2023,31083,Human infections,1,1,0,2
663,"NE, Hitchcock",2023,31087,Human infections,1,1,0,2
664,"NE, Holt",2023,31089,Human infections and non-human activity,3,1,0,4
665,"NE, Hooker",2023,31091,Human infections,1,0,0,1
666,"NE, Howard",2023,31093,Human infections,2,2,0,4
667,"NE, Kearney",2023,31099,Human infections,4,3,0,7
668,"NE, Keith",2023,31101,Human infections and non-human activity,1,1,1,3
669,"NE, Kimball",2023,31105,Human infections,2,1,0,3
670,"NE, Knox",2023,31107,Human infections and non-human activity,0,0,1,1
671,"NE, Lancaster",2023,31109,Human infections and non-human activity,23,10,11,44
672,"NE, Lincoln",2023,31111,Human infections and non-human activity,6,4,2,12
673,"NE, Madison",2023,31119,Human infections,3,3,2,8
674,"NE, Merrick",2023,31121,Human infections,2,2,0,4
675,"NE, Morrill",2023,31123,Human infections,1,0,0,1
676,"NE, Otoe",2023,31131,Non-human activity,0,0,0,0
677,"NE, Perkins",2023,31135,Human infections,4,2,1,7
678,"NE, Platte",2023,31141,Human infections and non-human activity,2,0,2,4
679,"NE, Polk",2023,31143,Non-human activity,0,0,0,0
680,"NE, Red Willow",2023,31145,Human infections and non-human activity,1,1,0,2
681,"NE, Richardson",2023,31147,Non-human activity,0,0,0,0
682,"NE, Saline",2023,31151,Human infections and non-human activity,0,0,1,1
683,"NE, Sarpy",2023,31153,Human infections and non-human activity,2,1,2,5
684,"NE, Saunders",2023,31155,Human infections and non-human activity,3,2,0,5
685,"NE, Scotts Bluff",2023,31157,Human infections and non-human activity,14,8,0,22
686,"NE, Seward",2023,31159,Human infections,2,1,2,5
687,"NE, Sheridan",2023,31161,Human infections,2,2,0,4
688,"NE, Sioux",2023,31165,Human infections and non-human activity,2,2,0,4
689,"NE, Stanton",2023,31167,Human infections,1,0,0,1
690,"NE, Thayer",2023,31169,Human infections,5,2,1,8
691,"NE, Thomas",2023,31171,Human infections,2,2,0,4
692,"NE, Valley",2023,31175,Non-human activity,0,0,0,0
693,"NE, Washington",2023,31177,Human infections,2,0,0,2
694,"NE, Wayne",2023,31179,Non-human activity,0,0,0,0
695,"NE, York",2023,31185,Human infections and non-human activity,2,1,2,5
696,"NV, Churchill",2023,32001,Non-human activity,0,0,0,0
697,"NV, Clark",2023,32003,Non-human activity,0,0,0,0
698,"NV, Washoe",2023,32031,Human infections,1,1,0,2
699,"NH, Merrimack",2023,33013,Human infections,1,1,0,2
700,"NH, Rockingham",2023,33015,Non-human activity,0,0,0,0
701,"NJ, Atlantic",2023,34001,Human infections and non-human activity,1,1,0,2
702,"NJ, Bergen",2023,34003,Human infections and non-human activity,4,3,0,7
703,"NJ, Burlington",2023,34005,Human infections and non-human activity,1,1,1,3
704,"NJ, Camden",2023,34007,Human infections and non-human activity,2,1,2,5
705,"NJ, Cape May",2023,34009,Non-human activity,0,0,0,0
706,"NJ, Cumberland",2023,34011,Non-human activity,0,0,0,0
707,"NJ, Essex",2023,34013,Non-human activity,0,0,0,0
708,"NJ, Gloucester",2023,34015,Non-human activity,0,0,0,0
709,"NJ, Hudson",2023,34017,Non-human activity,0,0,0,0
710,"NJ, Hunterdon",2023,34019,Non-human activity,0,0,0,0
711,"NJ, Mercer",2023,34021,Human infections and non-human activity,0,0,1,1
712,"NJ, Middlesex",2023,34023,Human infections and non-human activity,3,3,0,6
713,"NJ, Monmouth",2023,34025,Human infections and non-human activity,1,1,0,2
714,"NJ, Morris",2023,34027,Human infections and non-human activity,1,0,0,1
715,"NJ, Ocean",2023,34029,Non-human activity,0,0,0,0
716,"NJ, Passaic",2023,34031,Human infections and non-human activity,1,1,0,2
717,"NJ, Salem",2023,34033,Non-human activity,0,0,0,0
718,"NJ, Somerset",2023,34035,Non-human activity,0,0,0,0
719,"NJ, Sussex",2023,34037,Non-human activity,0,0,0,0
720,"NJ, Union",2023,34039,Non-human activity,0,0,0,0
721,"NJ, Warren",2023,34041,Non-human activity,0,0,0,0
722,"NM, Bernalillo",2023,35001,Human infections and non-human activity,19,10,4,33
723,"NM, Colfax",2023,35007,Human infections and non-human activity,1,1,0,2
724,"NM, Dona Ana",2023,35013,Human infections and non-human activity,1,1,0,2
725,"NM, Lea",2023,35025,Human infections,1,1,0,2
726,"NM, Lincoln",2023,35027,Human infections,1,1,0,2
727,"NM, Los Alamos",2023,35028,Human infections and non-human activity,1,0,0,1
728,"NM, Mckinley",2023,35031,Non-human activity,0,0,0,0
729,"NM, Mora",2023,35033,Human infections,1,1,0,2
730,"NM, Quay",2023,35037,Human infections,2,1,1,4
731,"NM, Rio Arriba",2023,35039,Human infections,4,3,2,9
732,"NM, Sandoval",2023,35043,Human infections and non-human activity,5,3,3,11
733,"NM, San Juan",2023,35045,Human infections,11,10,0,21
734,"NM, San Miguel",2023,35047,Human infections,4,2,0,6
735,"NM, Santa Fe",2023,35049,Human infections and non-human activity,8,5,0,13
736,"NM, Sierra",2023,35051,Non-human activity,0,0,0,0
737,"NM, Taos",2023,35055,Human infections and non-human activity,8,7,0,15
738,"NM, Torrance",2023,35057,Human infections and non-human activity,2,1,0,3
739,"NM, Union",2023,35059,Human infections and non-human activity,4,2,0,6
740,"NM, Valencia",2023,35061,Human infections and non-human activity,7,5,1,13
741,"NY, Bronx",2023,36005,Human infections and non-human activity,2,2,0,4
742,"NY, Broome",2023,36007,Human infections,1,1,0,2
743,"NY, Dutchess",2023,36027,Human infections,1,1,0,2
744,"NY, Erie",2023,36029,Non-human activity,0,0,0,0
745,"NY, Kings",2023,36047,Human infections and non-human activity,8,7,0,15
746,"NY, Lewis",2023,36049,Non-human activity,0,0,0,0
747,"NY, Madison",2023,36053,Non-human activity,0,0,0,0
748,"NY, Nassau",2023,36059,Human infections and non-human activity,9,4,1,14
749,"NY, New York",2023,36061,Human infections and non-human activity,5,5,0,10
750,"NY, Niagara",2023,36063,Human infections and non-human activity,2,1,0,3
751,"NY, Onondaga",2023,36067,Non-human activity,0,0,0,0
752,"NY, Orange",2023,36071,Non-human activity,0,0,0,0
753,"NY, Oswego",2023,36075,Non-human activity,0,0,0,0
754,"NY, Queens",2023,36081,Human infections and non-human activity,9,9,1,19
755,"NY, Richmond",2023,36085,Human infections and non-human activity,8,8,0,16
756,"NY, Rockland",2023,36087,Human infections and non-human activity,2,2,0,4
757,"NY, Suffolk",2023,36103,Human infections and non-human activity,4,1,0,5
758,"NY, Sullivan",2023,36105,Human infections,1,0,0,1
759,"NY, Westchester",2023,36119,Human infections and non-human activity,4,4,0,8
760,"NC, Beaufort",2023,37013,Human infections,1,1,0,2
761,"NC, Cabarrus",2023,37025,Human infections,1,1,0,2
762,"NC, Cumberland",2023,37051,Human infections,1,1,0,2
763,"NC, Davidson",2023,37057,Human infections,1,1,0,2
764,"NC, Durham",2023,37063,Human infections,0,0,1,1
765,"NC, Forsyth",2023,37067,Non-human activity,0,0,0,0
766,"NC, Gaston",2023,37071,Non-human activity,0,0,0,0
767,"NC, Lee",2023,37105,Human infections,1,1,0,2
768,"NC, Mecklenburg",2023,37119,Human infections,3,3,3,9
769,"NC, Moore",2023,37125,Human infections,1,1,0,2
770,"NC, New Hanover",2023,37129,Human infections and non-human activity,3,3,0,6
771,"NC, Robeson",2023,37155,Human infections,0,0,1,1
772,"NC, Wake",2023,37183,Human infections,3,3,1,7
773,"NC, Wayne",2023,37191,Human infections,0,0,1,1
774,"ND, Barnes",2023,38003,Human infections,3,3,0,6
775,"ND, Bottineau",2023,38009,Human infections,1,0,0,1
776,"ND, Burleigh",2023,38015,Human infections and non-human activity,11,6,0,17
777,"ND, Cass",2023,38017,Human infections and non-human activity,5,4,0,9
778,"ND, Emmons",2023,38029,Human infections,2,1,0,3
779,"ND, Foster",2023,38031,Human infections,0,0,2,2
780,"ND, Grand Forks",2023,38035,Human infections and non-human activity,0,0,2,2
781,"ND, Hettinger",2023,38041,Human infections,1,1,0,2
782,"ND, Mchenry",2023,38049,Human infections,2,1,1,4
783,"ND, Mckenzie",2023,38053,Human infections,0,0,1,1
784,"ND, Mclean",2023,38055,Human infections,1,0,0,1
785,"ND, Mercer",2023,38057,Human infections,3,2,0,5
786,"ND, Morton",2023,38059,Human infections,6,3,0,9
787,"ND, Mountrail",2023,38061,Human infections,2,0,0,2
788,"ND, Ramsey",2023,38071,Human infections,1,0,2,3
789,"ND, Richland",2023,38077,Human infections and non-human activity,2,1,0,3
790,"ND, Sargent",2023,38081,Human infections,2,1,2,5
791,"ND, Sioux",2023,38085,Human infections,1,0,0,1
792,"ND, Stark",2023,38089,Human infections,2,2,0,4
793,"ND, Stutsman",2023,38093,Human infections,3,1,1,5
794,"ND, Ward",2023,38101,Human infections,5,4,2,11
795,"ND, Williams",2023,38105,Human infections and non-human activity,5,3,1,9
796,"OH, Allen",2023,39003,Human infections,1,1,0,2
797,"OH, Ashtabula",2023,39007,Non-human activity,0,0,0,0
798,"OH, Athens",2023,39009,Non-human activity,0,0,0,0
799,"OH, Auglaize",2023,39011,Human infections and non-human activity,1,1,0,2
800,"OH, Butler",2023,39017,Human infections,1,1,0,2
801,"OH, Carroll",2023,39019,Non-human activity,0,0,0,0
802,"OH, Clark",2023,39023,Non-human activity,0,0,0,0
803,"OH, Clermont",2023,39025,Human infections and non-human activity,0,0,1,1
804,"OH, Columbiana",2023,39029,Human infections and non-human activity,1,1,0,2
805,"OH, Crawford",2023,39033,Non-human activity,0,0,0,0
806,"OH, Cuyahoga",2023,39035,Human infections and non-human activity,1,1,0,2
807,"OH, Defiance",2023,39039,Non-human activity,0,0,0,0
808,"OH, Delaware",2023,39041,Non-human activity,0,0,0,0
809,"OH, Fairfield",2023,39045,Non-human activity,0,0,0,0
810,"OH, Franklin",2023,39049,Human infections and non-human activity,2,2,0,4
811,"OH, Geauga",2023,39055,Non-human activity,0,0,0,0
812,"OH, Greene",2023,39057,Non-human activity,0,0,0,0
813,"OH, Hamilton",2023,39061,Human infections and non-human activity,2,2,2,6
814,"OH, Hancock",2023,39063,Non-human activity,0,0,0,0
815,"OH, Henry",2023,39069,Non-human activity,0,0,0,0
816,"OH, Highland",2023,39071,Human infections,1,0,0,1
817,"OH, Lake",2023,39085,Non-human activity,0,0,0,0
818,"OH, Licking",2023,39089,Non-human activity,0,0,0,0
819,"OH, Lorain",2023,39093,Non-human activity,0,0,0,0
820,"OH, Medina",2023,39103,Human infections and non-human activity,1,1,0,2
821,"OH, Mercer",2023,39107,Human infections,1,1,0,2
822,"OH, Miami",2023,39109,Non-human activity,0,0,0,0
823,"OH, Montgomery",2023,39113,Human infections and non-human activity,2,2,0,4
824,"OH, Muskingum",2023,39119,Non-human activity,0,0,0,0
825,"OH, Ottawa",2023,39123,Human infections and non-human activity,1,0,1,2
826,"OH, Paulding",2023,39125,Non-human activity,0,0,0,0
827,"OH, Pickaway",2023,39129,Non-human activity,0,0,0,0
828,"OH, Portage",2023,39133,Non-human activity,0,0,0,0
829,"OH, Putnam",2023,39137,Non-human activity,0,0,0,0
830,"OH, Richland",2023,39139,Non-human activity,0,0,0,0
831,"OH, Ross",2023,39141,Non-human activity,0,0,0,0
832,"OH, Stark",2023,39151,Human infections and non-human activity,2,2,0,4
833,"OH, Summit",2023,39153,Human infections and non-human activity,1,1,0,2
834,"OH, Trumbull",2023,39155,Non-human activity,0,0,0,0
835,"OH, Tuscarawas",2023,39157,Non-human activity,0,0,0,0
836,"OH, Union",2023,39159,Non-human activity,0,0,0,0
837,"OH, Van Wert",2023,39161,Non-human activity,0,0,0,0
838,"OH, Vinton",2023,39163,Non-human activity,0,0,0,0
839,"OH, Warren",2023,39165,Non-human activity,0,0,0,0
840,"OH, Wood",2023,39173,Non-human activity,0,0,0,0
841,"OH, Wyandot",2023,39175,Non-human activity,0,0,0,0
842,"OK, Alfalfa",2023,40003,Human infections,0,0,1,1
843,"OK, Beaver",2023,40007,Human infections,5,4,0,9
844,"OK, Beckham",2023,40009,Human infections and non-human activity,2,1,0,3
845,"OK, Caddo",2023,40015,Non-human activity,0,0,0,0
846,"OK, Canadian",2023,40017,Human infections,0,0,1,1
847,"OK, Carter",2023,40019,Non-human activity,0,0,0,0
848,"OK, Cherokee",2023,40021,Non-human activity,0,0,0,0
849,"OK, Cleveland",2023,40027,Human infections and non-human activity,1,1,1,3
850,"OK, Coal",2023,40029,Non-human activity,0,0,0,0
851,"OK, Comanche",2023,40031,Human infections and non-human activity,1,1,1,3
852,"OK, Cotton",2023,40033,Non-human activity,0,0,0,0
853,"OK, Ellis",2023,40045,Human infections,2,0,0,2
854,"OK, Grady",2023,40051,Human infections,0,0,1,1
855,"OK, Grant",2023,40053,Human infections,1,0,1,2
856,"OK, Harper",2023,40059,Human infections and non-human activity,3,1,0,4
857,"OK, Hughes",2023,40063,Human infections and non-human activity,1,1,0,2
858,"OK, Jackson",2023,40065,Non-human activity,0,0,0,0
859,"OK, Kay",2023,40071,Human infections and non-human activity,1,1,0,2
860,"OK, Le Flore",2023,40079,Non-human activity,0,0,0,0
861,"OK, Mcintosh",2023,40091,Non-human activity,0,0,0,0
862,"OK, Major",2023,40093,Human infections,1,1,0,2
863,"OK, Marshall",2023,40095,Non-human activity,0,0,0,0
864,"OK, Muskogee",2023,40101,Human infections and non-human activity,1,1,0,2
865,"OK, Oklahoma",2023,40109,Human infections and non-human activity,14,13,3,30
866,"OK, Ottawa",2023,40115,Non-human activity,0,0,0,0
867,"OK, Pawnee",2023,40117,Non-human activity,0,0,0,0
868,"OK, Payne",2023,40119,Non-human activity,0,0,0,0
869,"OK, Pittsburg",2023,40121,Human infections and non-human activity,3,3,0,6
870,"OK, Pontotoc",2023,40123,Non-human activity,0,0,0,0
871,"OK, Pottawatomie",2023,40125,Human infections,1,1,0,2
872,"OK, Roger Mills",2023,40129,Human infections,0,0,1,1
873,"OK, Rogers",2023,40131,Human infections,1,1,0,2
874,"OK, Seminole",2023,40133,Human infections,1,1,0,2
875,"OK, Stephens",2023,40137,Human infections and non-human activity,1,1,1,3
876,"OK, Texas",2023,40139,Human infections,1,1,0,2
877,"OK, Tulsa",2023,40143,Human infections and non-human activity,7,4,2,13
878,"OK, Wagoner",2023,40145,Human infections,1,0,0,1
879,"OK, Washington",2023,40147,Human infections,2,2,0,4
880,"OK, Washita",2023,40149,Non-human activity,0,0,0,0
881,"OK, Woods",2023,40151,Human infections,1,0,0,1
882,"OK, Woodward",2023,40153,Non-human activity,0,0,0,0
883,"OR, Baker",2023,41001,Human infections and non-human activity,3,2,0,5
884,"OR, Benton",2023,41003,Human infections,2,1,0,3
885,"OR, Deschutes",2023,41017,Human infections,0,0,2,2
886,"OR, Harney",2023,41025,Human infections and non-human activity,3,2,0,5
887,"OR, Jackson",2023,41029,Human infections and non-human activity,1,0,0,1
888,"OR, Klamath",2023,41035,Human infections and non-human activity,1,1,0,2
889,"OR, Malheur",2023,41045,Human infections and non-human activity,6,3,0,9
890,"OR, Morrow",2023,41049,Non-human activity,0,0,0,0
891,"OR, Multnomah",2023,41051,Human infections,1,0,0,1
892,"OR, Umatilla",2023,41059,Non-human activity,0,0,0,0
893,"OR, Union",2023,41061,Non-human activity,0,0,0,0
894,"OR, Washington",2023,41067,Human infections,0,0,1,1
895,"PA, Adams",2023,42001,Non-human activity,0,0,0,0
896,"PA, Allegheny",2023,42003,Human infections and non-human activity,1,1,0,2
897,"PA, Beaver",2023,42007,Non-human activity,0,0,0,0
898,"PA, Berks",2023,42011,Non-human activity,0,0,0,0
899,"PA, Blair",2023,42013,Non-human activity,0,0,0,0
900,"PA, Bucks",2023,42017,Human infections and non-human activity,1,1,0,2
901,"PA, Butler",2023,42019,Non-human activity,0,0,0,0
902,"PA, Cambria",2023,42021,Non-human activity,0,0,0,0
903,"PA, Carbon",2023,42025,Non-human activity,0,0,0,0
904,"PA, Centre",2023,42027,Human infections and non-human activity,1,0,0,1
905,"PA, Chester",2023,42029,Non-human activity,0,0,0,0
906,"PA, Clearfield",2023,42033,Non-human activity,0,0,0,0
907,"PA, Clinton",2023,42035,Non-human activity,0,0,0,0
908,"PA, Columbia",2023,42037,Non-human activity,0,0,0,0
909,"PA, Crawford",2023,42039,Non-human activity,0,0,0,0
910,"PA, Cumberland",2023,42041,Non-human activity,0,0,0,0
911,"PA, Dauphin",2023,42043,Non-human activity,0,0,0,0
912,"PA, Delaware",2023,42045,Human infections and non-human activity,3,3,0,6
913,"PA, Erie",2023,42049,Non-human activity,0,0,0,0
914,"PA, Fayette",2023,42051,Human infections and non-human activity,1,1,0,2
915,"PA, Franklin",2023,42055,Non-human activity,0,0,0,0
916,"PA, Fulton",2023,42057,Non-human activity,0,0,0,0
917,"PA, Greene",2023,42059,Non-human activity,0,0,0,0
918,"PA, Huntingdon",2023,42061,Non-human activity,0,0,0,0
919,"PA, Indiana",2023,42063,Non-human activity,0,0,0,0
920,"PA, Juniata",2023,42067,Non-human activity,0,0,0,0
921,"PA, Lackawanna",2023,42069,Human infections and non-human activity,1,0,0,1
922,"PA, Lancaster",2023,42071,Non-human activity,0,0,0,0
923,"PA, Lawrence",2023,42073,Non-human activity,0,0,0,0
924,"PA, Lebanon",2023,42075,Non-human activity,0,0,0,0
925,"PA, Lehigh",2023,42077,Human infections and non-human activity,1,1,0,2
926,"PA, Luzerne",2023,42079,Non-human activity,0,0,0,0
927,"PA, Lycoming",2023,42081,Non-human activity,0,0,0,0
928,"PA, Mercer",2023,42085,Non-human activity,0,0,0,0
929,"PA, Mifflin",2023,42087,Non-human activity,0,0,0,0
930,"PA, Monroe",2023,42089,Non-human activity,0,0,0,0
931,"PA, Montgomery",2023,42091,Human infections and non-human activity,3,3,1,7
932,"PA, Montour",2023,42093,Non-human activity,0,0,0,0
933,"PA, Northampton",2023,42095,Human infections and non-human activity,1,1,0,2
934,"PA, Northumberland",2023,42097,Human infections and non-human activity,2,1,0,3
935,"PA, Perry",2023,42099,Non-human activity,0,0,0,0
936,"PA, Philadelphia",2023,42101,Human infections and non-human activity,6,5,2,13
937,"PA, Pike",2023,42103,Non-human activity,0,0,0,0
938,"PA, Schuylkill",2023,42107,Non-human activity,0,0,0,0
939,"PA, Snyder",2023,42109,Non-human activity,0,0,0,0
940,"PA, Union",2023,42119,Non-human activity,0,0,0,0
941,"PA, Warren",2023,42123,Non-human activity,0,0,0,0
942,"PA, Washington",2023,42125,Non-human activity,0,0,0,0
943,"PA, Westmoreland",2023,42129,Non-human activity,0,0,0,0
944,"PA, York",2023,42133,Human infections and non-human activity,1,1,1,3
945,"RI, Bristol",2023,44001,Non-human activity,0,0,0,0
946,"RI, Newport",2023,44005,Human infections and non-human activity,1,1,0,2
947,"RI, Providence",2023,44007,Non-human activity,0,0,0,0
948,"RI, Washington",2023,44009,Non-human activity,0,0,0,0
949,"SC, Beaufort",2023,45013,Non-human activity,0,0,0,0
950,"SC, Colleton",2023,45029,Non-human activity,0,0,0,0
951,"SC, Florence",2023,45041,Non-human activity,0,0,0,0
952,"SC, Georgetown",2023,45043,Non-human activity,0,0,0,0
953,"SC, Greenville",2023,45045,Non-human activity,0,0,0,0
954,"SC, Greenwood",2023,45047,Non-human activity,0,0,0,0
955,"SC, Horry",2023,45051,Non-human activity,0,0,0,0
956,"SC, Kershaw",2023,45055,Non-human activity,0,0,0,0
957,"SC, Lexington",2023,45063,Non-human activity,0,0,0,0
958,"SC, Richland",2023,45079,Non-human activity,0,0,0,0
959,"SC, Spartanburg",2023,45083,Non-human activity,0,0,0,0
960,"SD, Beadle",2023,46005,Human infections and non-human activity,4,1,0,5
961,"SD, Bon Homme",2023,46009,Human infections,2,1,0,3
962,"SD, Brookings",2023,46011,Human infections and non-human activity,1,1,0,2
963,"SD, Brown",2023,46013,Human infections and non-human activity,9,4,2,15
964,"SD, Buffalo",2023,46017,Human infections,1,1,0,2
965,"SD, Campbell",2023,46021,Human infections,1,0,0,1
966,"SD, Charles Mix",2023,46023,Human infections,0,0,1,1
967,"SD, Clark",2023,46025,Human infections,2,1,0,3
968,"SD, Codington",2023,46029,Human infections and non-human activity,2,1,1,4
969,"SD, Corson",2023,46031,Human infections,1,0,0,1
970,"SD, Custer",2023,46033,Human infections,0,0,1,1
971,"SD, Davison",2023,46035,Human infections and non-human activity,4,1,0,5
972,"SD, Day",2023,46037,Human infections,2,0,0,2
973,"SD, Deuel",2023,46039,Human infections,2,1,0,3
974,"SD, Dewey",2023,46041,Human infections,3,2,0,5
975,"SD, Douglas",2023,46043,Human infections,0,0,1,1
976,"SD, Edmunds",2023,46045,Human infections,1,1,0,2
977,"SD, Fall River",2023,46047,Human infections,1,1,0,2
978,"SD, Faulk",2023,46049,Human infections,3,0,1,4
979,"SD, Hamlin",2023,46057,Human infections,2,1,0,3
980,"SD, Hand",2023,46059,Human infections and non-human activity,1,0,0,1
981,"SD, Hughes",2023,46065,Human infections and non-human activity,5,3,0,8
982,"SD, Hutchinson",2023,46067,Human infections,1,0,0,1
983,"SD, Jerauld",2023,46073,Human infections,1,1,0,2
984,"SD, Kingsbury",2023,46077,Human infections,3,1,0,4
985,"SD, Lake",2023,46079,Human infections,1,0,0,1
986,"SD, Lawrence",2023,46081,Human infections,0,0,1,1
987,"SD, Lincoln",2023,46083,Human infections and non-human activity,5,4,0,9
988,"SD, Lyman",2023,46085,Human infections,1,1,0,2
989,"SD, Mccook",2023,46087,Human infections,1,0,0,1
990,"SD, Marshall",2023,46091,Human infections,1,0,0,1
991,"SD, Meade",2023,46093,Human infections and non-human activity,2,2,0,4
992,"SD, Miner",2023,46097,Human infections,1,0,0,1
993,"SD, Minnehaha",2023,46099,Human infections and non-human activity,11,6,1,18
994,"SD, Moody",2023,46101,Human infections,1,1,0,2
995,"SD, Oglala Lakota County",2023,46102,Human infections,5,2,0,7
996,"SD, Pennington",2023,46103,Human infections,5,5,1,11
997,"SD, Perkins",2023,46105,Human infections,1,0,0,1
998,"SD, Sanborn",2023,46111,Human infections,1,0,0,1
999,"SD, Spink",2023,46115,Human infections,1,0,0,1
1000,"SD, Union",2023,46127,Human infections,1,1,0,2
1001,"SD, Walworth",2023,46129,Human infections,1,1,0,2
1002,"SD, Yankton",2023,46135,Human infections,2,1,1,4
1003,"TN, Davidson",2023,47037,Human infections and non-human activity,2,2,1,5
1004,"TN, Hamblen",2023,47063,Human infections,1,1,0,2
1005,"TN, Henry",2023,47079,Non-human activity,0,0,0,0
1006,"TN, Jefferson",2023,47089,Human infections,1,1,0,2
1007,"TN, Knox",2023,47093,Non-human activity,0,0,0,0
1008,"TN, Meigs",2023,47121,Non-human activity,0,0,0,0
1009,"TN, Obion",2023,47131,Human infections,1,1,0,2
1010,"TN, Rutherford",2023,47149,Human infections,2,2,0,4
1011,"TN, Shelby",2023,47157,Human infections and non-human activity,7,5,2,14
1012,"TN, Williamson",2023,47187,Human infections,1,1,0,2
1013,"TX, Armstrong",2023,48011,Human infections,1,1,0,2
1014,"TX, Bell",2023,48027,Human infections and non-human activity,3,2,0,5
1015,"TX, Bexar",2023,48029,Human infections and non-human activity,4,4,1,9
1016,"TX, Bosque",2023,48035,Non-human activity,0,0,0,0
1017,"TX, Bowie",2023,48037,Human infections,3,2,0,5
1018,"TX, Brazoria",2023,48039,Non-human activity,0,0,0,0
1019,"TX, Brazos",2023,48041,Non-human activity,0,0,0,0
1020,"TX, Briscoe",2023,48045,Human infections,1,0,0,1
1021,"TX, Carson",2023,48065,Human infections,1,1,2,4
1022,"TX, Castro",2023,48069,Human infections and non-human activity,1,1,0,2
1023,"TX, Collin",2023,48085,Human infections and non-human activity,2,0,1,3
1024,"TX, Cooke",2023,48097,Non-human activity,0,0,0,0
1025,"TX, Crosby",2023,48107,Human infections,2,1,0,3
1026,"TX, Dallam",2023,48111,Human infections,1,1,0,2
1027,"TX, Dallas",2023,48113,Human infections and non-human activity,21,15,1,37
1028,"TX, Dawson",2023,48115,Human infections,1,1,0,2
1029,"TX, Deaf Smith",2023,48117,Human infections and non-human activity,2,2,0,4
1030,"TX, Denton",2023,48121,Human infections and non-human activity,5,3,2,10
1031,"TX, Donley",2023,48129,Human infections,1,1,0,2
1032,"TX, Ector",2023,48135,Human infections,1,1,0,2
1033,"TX, Ellis",2023,48139,Non-human activity,0,0,0,0
1034,"TX, El Paso",2023,48141,Human infections and non-human activity,5,5,1,11
1035,"TX, Erath",2023,48143,Non-human activity,0,0,0,0
1036,"TX, Floyd",2023,48153,Human infections,1,0,0,1
1037,"TX, Fort Bend",2023,48157,Non-human activity,0,0,0,0
1038,"TX, Franklin",2023,48159,Human infections,1,1,1,3
1039,"TX, Galveston",2023,48167,Human infections and non-human activity,1,1,0,2
1040,"TX, Glasscock",2023,48173,Human infections,1,1,0,2
1041,"TX, Gray",2023,48179,Human infections and non-human activity,1,1,0,2
1042,"TX, Grayson",2023,48181,Human infections and non-human activity,5,5,0,10
1043,"TX, Gregg",2023,48183,Human infections,1,1,0,2
1044,"TX, Hale",2023,48189,Human infections,1,0,0,1
1045,"TX, Hansford",2023,48195,Human infections,2,1,0,3
1046,"TX, Harris",2023,48201,Human infections and non-human activity,2,1,3,6
1047,"TX, Hartley",2023,48205,Human infections,1,1,1,3
1048,"TX, Hemphill",2023,48211,Human infections,2,1,0,3
1049,"TX, Henderson",2023,48213,Human infections,1,1,0,2
1050,"TX, Hockley",2023,48219,Human infections,1,1,0,2
1051,"TX, Houston",2023,48225,Non-human activity,0,0,0,0
1052,"TX, Hunt",2023,48231,Human infections and non-human activity,2,2,0,4
1053,"TX, Hutchinson",2023,48233,Human infections,6,4,1,11
1054,"TX, Jefferson",2023,48245,Non-human activity,0,0,0,0
1055,"TX, Johnson",2023,48251,Non-human activity,0,0,0,0
1056,"TX, Lipscomb",2023,48295,Human infections,1,0,0,1
1057,"TX, Lubbock",2023,48303,Human infections and non-human activity,5,4,5,14
1058,"TX, Lynn",2023,48305,Human infections,2,2,0,4
1059,"TX, Martin",2023,48317,Human infections,1,1,0,2
1060,"TX, Midland",2023,48329,Non-human activity,0,0,0,0
1061,"TX, Montgomery",2023,48339,Human infections and non-human activity,4,3,0,7
1062,"TX, Moore",2023,48341,Human infections and non-human activity,1,1,1,3
1063,"TX, Ochiltree",2023,48357,Human infections,4,2,0,6
1064,"TX, Orange",2023,48361,Non-human activity,0,0,0,0
1065,"TX, Parmer",2023,48369,Human infections,2,2,0,4
1066,"TX, Potter",2023,48375,Human infections and non-human activity,7,1,1,9
1067,"TX, Randall",2023,48381,Human infections and non-human activity,9,5,4,18
1068,"TX, Roberts",2023,48393,Non-human activity,0,0,0,0
1069,"TX, Rockwall",2023,48397,Non-human activity,0,0,0,0
1070,"TX, San Augustine",2023,48405,Human infections,1,1,0,2
1071,"TX, Smith",2023,48423,Human infections,5,5,0,10
1072,"TX, Swisher",2023,48437,Human infections,1,1,0,2
1073,"TX, Tarrant",2023,48439,Human infections and non-human activity,12,11,1,24
1074,"TX, Taylor",2023,48441,Human infections and non-human activity,1,1,0,2
1075,"TX, Terry",2023,48445,Non-human activity,0,0,0,0
1076,"TX, Travis",2023,48453,Human infections and non-human activity,3,1,2,6
1077,"TX, Upshur",2023,48459,Human infections,2,2,0,4
1078,"TX, Victoria",2023,48469,Human infections,1,1,0,2
1079,"TX, Wheeler",2023,48483,Non-human activity,0,0,0,0
1080,"TX, Wichita",2023,48485,Non-human activity,0,0,0,0
1081,"TX, Williamson",2023,48491,Human infections and non-human activity,1,1,0,2
1082,"TX, Wise",2023,48497,Non-human activity,0,0,0,0
1083,"TX, Zavala",2023,48507,Human infections,1,1,0,2
1084,"UT, Box Elder",2023,49003,Non-human activity,0,0,0,0
1085,"UT, Cache",2023,49005,Non-human activity,0,0,0,0
1086,"UT, Davis",2023,49011,Human infections and non-human activity,2,1,1,4
1087,"UT, Duchesne",2023,49013,Human infections and non-human activity,1,0,0,1
1088,"UT, Emery",2023,49015,Non-human activity,0,0,0,0
1089,"UT, Garfield",2023,49017,Non-human activity,0,0,0,0
1090,"UT, Grand",2023,49019,Non-human activity,0,0,0,0
1091,"UT, Millard",2023,49027,Non-human activity,0,0,0,0
1092,"UT, Rich",2023,49033,Non-human activity,0,0,0,0
1093,"UT, Salt Lake",2023,49035,Human infections and non-human activity,1,1,0,2
1094,"UT, Tooele",2023,49045,Non-human activity,0,0,0,0
1095,"UT, Uintah",2023,49047,Human infections and non-human activity,1,0,0,1
1096,"UT, Utah",2023,49049,Non-human activity,0,0,0,0
1097,"UT, Wasatch",2023,49051,Non-human activity,0,0,0,0
1098,"UT, Washington",2023,49053,Human infections and non-human activity,1,1,0,2
1099,"UT, Weber",2023,49057,Human infections and non-human activity,2,2,0,4
1100,"VT, Addison",2023,50001,Non-human activity,0,0,0,0
1101,"VT, Chittenden",2023,50007,Non-human activity,0,0,0,0
1102,"VT, Franklin",2023,50011,Non-human activity,0,0,0,0
1103,"VT, Grand Isle",2023,50013,Non-human activity,0,0,0,0
1104,"VA, Fairfax",2023,51059,Human infections and non-human activity,3,2,1,6
1105,"VA, Greene",2023,51079,Human infections,1,0,0,1
1106,"VA, Henrico",2023,51087,Human infections and non-human activity,2,2,0,4
1107,"VA, Isle Of Wight",2023,51093,Human infections,1,1,0,2
1108,"VA, Loudoun",2023,51107,Human infections,1,0,0,1
1109,"VA, Prince William",2023,51153,Non-human activity,0,0,0,0
1110,"VA, Westmoreland",2023,51193,Human infections,1,1,0,2
1111,"VA, York",2023,51199,Non-human activity,0,0,0,0
1112,"VA, Chesapeake City",2023,51550,Non-human activity,0,0,0,0
1113,"VA, Fairfax City",2023,51600,Non-human activity,0,0,0,0
1114,"VA, Falls Church City",2023,51610,Non-human activity,0,0,0,0
1115,"VA, Hampton City",2023,51650,Human infections,1,1,0,2
1116,"VA, Newport News City",2023,51700,Human infections,1,1,0,2
1117,"VA, Norfolk City",2023,51710,Non-human activity,0,0,0,0
1118,"VA, Petersburg City",2023,51730,Human infections,1,1,0,2
1119,"VA, Suffolk City",2023,51800,Non-human activity,0,0,0,0
1120,"VA, Virginia Beach City",2023,51810,Human infections,0,0,1,1
1121,"WA, Benton",2023,53005,Non-human activity,0,0,0,0
1122,"WA, Clark",2023,53011,Human infections,1,1,0,2
1123,"WA, Grant",2023,53025,Non-human activity,0,0,0,0
1124,"WA, King",2023,53033,Human infections,1,0,0,1
1125,"WA, Walla Walla",2023,53071,Human infections,2,2,0,4
1126,"WA, Yakima",2023,53077,Non-human activity,0,0,0,0
1127,"WV, Hardy",2023,54031,Human infections,1,1,0,2
1128,"WV, Monongalia",2023,54061,Human infections,1,1,0,2
1129,"WI, Brown",2023,55009,Human infections,1,1,1,3
1130,"WI, Clark",2023,55019,Non-human activity,0,0,0,0
1131,"WI, Crawford",2023,55023,Human infections,1,1,0,2
1132,"WI, Dane",2023,55025,Human infections and non-human activity,7,7,3,17
1133,"WI, Douglas",2023,55031,Human infections,1,1,0,2
1134,"WI, Dunn",2023,55033,Non-human activity,0,0,0,0
1135,"WI, Fond Du Lac",2023,55039,Human infections,1,1,0,2
1136,"WI, Grant",2023,55043,Non-human activity,0,0,0,0
1137,"WI, Green",2023,55045,Human infections,1,1,0,2
1138,"WI, Jefferson",2023,55055,Human infections,1,1,0,2
1139,"WI, Kewaunee",2023,55061,Human infections,1,1,0,2
1140,"WI, Lafayette",2023,55065,Non-human activity,0,0,0,0
1141,"WI, Lincoln",2023,55069,Human infections,0,0,1,1
1142,"WI, Marathon",2023,55073,Human infections,1,1,0,2
1143,"WI, Marinette",2023,55075,Human infections,1,1,0,2
1144,"WI, Milwaukee",2023,55079,Human infections and non-human activity,7,6,0,13
1145,"WI, Pierce",2023,55093,Human infections,1,0,1,2
1146,"WI, Racine",2023,55101,Human infections,0,0,1,1
1147,"WI, Waukesha",2023,55133,Human infections,1,1,0,2
1148,"WY, Albany",2023,56001,Non-human activity,0,0,0,0
1149,"WY, Big Horn",2023,56003,Non-human activity,0,0,0,0
1150,"WY, Campbell",2023,56005,Human infections and non-human activity,1,1,0,2
1151,"WY, Carbon",2023,56007,Human infections and non-human activity,1,0,0,1
1152,"WY, Converse",2023,56009,Non-human activity,0,0,0,0
1153,"WY, Crook",2023,56011,Non-human activity,0,0,0,0
1154,"WY, Fremont",2023,56013,Human infections and non-human activity,2,1,0,3
1155,"WY, Goshen",2023,56015,Human infections and non-human activity,7,3,2,12
1156,"WY, Hot Springs",2023,56017,Non-human activity,0,0,0,0
1157,"WY, Johnson",2023,56019,Non-human activity,0,0,0,0
1158,"WY, Laramie",2023,56021,Human infections and non-human activity,6,4,5,15
1159,"WY, Natrona",2023,56025,Human infections and non-human activity,3,2,4,9
1160,"WY, Niobrara",2023,56027,Human infections,0,0,1,1
1161,"WY, Park",2023,56029,Human infections and non-human activity,1,1,0,2
1162,"WY, Platte",2023,56031,Human infections,3,0,1,4
1163,"WY, Sheridan",2023,56033,Human infections and non-human activity,1,1,0,2
1164,"WY, Sweetwater",2023,56037,Non-human activity,0,0,0,0
1165,"WY, Teton",2023,56039,Human infections and non-human activity,0,0,1,1
1166,"WY, Uinta",2023,56041,Non-human activity,0,0,0,0
1167,"WY, Washakie",2023,56043,Human infections and non-human activity,2,0,0,2
